10,10
---------E
-B99999BXX
-V-----V-X
----------
----------
-C--------
XXB55555B-
--V-----VC
-----E----
--R-------