6,10
---------E
-B44444B--
-V-----V--
R---------
--B55555B-
--V-----VC